




SO ./image/wallnumber1.xpm
NO ./image/wallnumber5.xpm
WE ./image/wallnumber3.xpm
EA ./image/wallnumber6.xpm





C 0,0,0
F 80,80,80



111111111111111
1S0000100000001
10000011111111111111111111111111111111111111111111111111
10000010000000000000010000001000000001000000010000000001
10000010000000000000000000000000000001000000010000000001
10000010000000000000010000000000010001000100010001000001
11101111111011111111110000000000010001000100010001000001
110000110000001      10000001000010001000100010001000001
100000010000001      10000000000010000000100000001000001
100000010000001      10000000000010000000100000001000001
10000000000000111111111000000000011111111111111111001111
1000000100000010000000000000000101               1001
100000010000001000000000000000000111111          1001
110000110000001001100000000000110010001          1001
111111111111110001000000000000010010001          1001
             10000000000000000000010001          1001
             10000000000000000000010001          1001
             10000000011110000000000001          1001
             1000000001111000000001000111111111111001
             1000000001111000000001000000000000000001
             1000000000000000000001000111111111111111
             10001000000000000010010001
             10001100000000000110010001
             10000000000000000000010001
             11111111111111111111111111


