




F 52,55,25
SO ./image/south.xpm







C 1,74,25

NO        ./image/north.xpm




     


WE ./image/west.xpm
EA ./image/east.xpm








        1111111111111111111111111
        1000001000110000000000001
        101100000111S0000100000011
        100100000000000000000000111111111
111111111111111111011000001110000000000001
10000000001100000111011111111111111111111
11110111111111011100000010001
11110111111111011101010010001
11000000011010101100000010001
10000000000000001100000010001
10000000000000001101010000001
110000011101010111110111100111
11110111111101011101111010001
11111111111111111111111111111